11111111111111111111111111111111111111111
1E0NNN00000CC0000000000000NNN000000000001
10000000CCC000000000N000N000100000000CCC1
1000N000CCC000N0000CCCCCC010000000000CNC1
1000000N0000N0C000000N0000N1N00000000CCC1
1000N000000000C00N00000000N1N000000000001
1P000000N00000C000NNN00CCCN1N000000000001
11111111111111111111111111111111111111111
