111111111111111111111111111111
1E0NNN00000CCCCCC0000000000001
10000000CCCCCCC000000000N00001
1000N000CCCCCCC000N0000CCCCCC1
1000000N0000N0C000000N00000001
1000N000000000C00N00000000N001
1P000000N00000C000NNN00CCCCCC1
111111111111111111111111111111
