111111111111
1P00000C01C1
1E0C0C1N0001
111111111111
