1111111111111
1EP00000000C1
1111111111111
